----g-----
----------
----------
----------
----b---r-
----------
0 5
0