--------------
b---b--b---b--
-b-b----b-b---
--b------b----
--b------b----
--b------b----
--------------
13 5
0
