-k----k-
kk-kk-k-
---kk-k-
---k-r--
--k-----
0 2
0
