------------
-g---g----r-
-g--r-------
--g--b--r-b-
-b----------
------------
0 1
0
