k---k---k---kkk
--------------k
--------------k
---------------
k--------------
---------------
k-------------k
--k---k---k---k
0 0
0
