-------k-------
---kk---------k
---k-----------
----------k----
-----k-----k---
-----kk--------
k---k----------
-----------kkk-
0 0 
0
