bk------
b-----r-
bk------
bk------
bk------
kk------
6 0
1
