---------------------
---------------------
---k---kk----kkk--k--
-------kk----kkk--k--
-------kk---------k--
------------------k--
---------------------
0 5
0
