-------------------------
-b---b-b---b-b---b-b---b-
-------------------------
-b---b-b---b-b---b-b---b-
--bbb---bbb---bbb---bbb--
-------------------------
23 4
0
