-------------
-------------
kkkkg--------
----g--------
----g--------
---kkkkkg----
--------g----
--------g----
--------g----
-----kkkkkkkk
0 8
2
