-------b-b--b-
-------b-b--b-
-------b-b--b-
--k-k-kb-b--b-
--g-g-gb-b--b-
--g-g-gk-k--k-
--g-g-g-------
13 2
0