--------------
--------------
--------------
--k-k-k-------
--------------
-------k-k--k-
--------------
0 2
0