--b-------b--b----
--b-------b--b----
--b--k-k--b--b--k-
--b--g-g--b--b--g-
--k--g-g--k--k--g-
-----g-g--------g-
-----g-g--------g-
-----g-g--------g-
17 4
0