-b-b-b-------
b-b-b-b------
-b-b-b-------
b-b-b-b------
kkkkkkk------
-------------
-------------
-------------
-------------
-------------
-------------
-------------
-------------
-------------
r-r-r-r-r-r-r
0 0 
0
