----b----b------r--r-
--gg---------g---g---
---r---r--b--------b-
---------------------
-g---g--r---r---b-b--
---r---r------b--b---
0 0
0
