-------------
-------------
-----b-b-----
-------------
----b---b----
-----bbb-----
-------------
0 0
0