-------------
----b---b----
-----b-b-----
------b------
------b------
------b------
-------------
12 0
0