------------------
------------------
------------------
----g----g-----g--
--r-g--b-g--r--g--
kkkkkkkkkkkkkkkkkk
0 1 
0
