--------------------
--------------------
--------------------
------g----------g--
--b---g---r------g--
kkkkkkkkkkkkkkkkkkkk
0 1 
0
