--------------------
--------------------
------b----------r--
------g----------g--
------g----------g--
kkkkkkkkkkkkkkkkkkkk
19 1 
0
