------------------
------------------
----r----b-----r--
----g----g-----g--
----g----g-----g--
kkkkkkkkkkkkkkkkkk
17 1 
0
