-----g-----g-
---b----b----
--r--r-------
------g--g---
----b------b-
0 0
0
